111111111111111111111111111111
100000011110000000011110000001
100000000000000000000000000001
10S000000000011110000000000S01
111110000000000000000000011111
100000001111111111111100000001
100000000000000000000000000001
10S00000000000S000000000000S01
101110000000111111000000011101
100000000000000000000000000001
100000011100000000011100000001
10S000000000000000000000000S01
111110000000000000000000011111
100000000000011110000000000001
100000000000000000000000000001
1000000S00000000000000S0000001
100001111000000000000111100001
100000000000000000000000000001
100000000000000000000000000001
112211111122111111221111112211
111111111111111111111111111111
111111111111111111111111111111
111111111111111111111111111111
